XXXXXXXXXXXXXXXXXXXXXXXXXXXXXXXXXXXXXXXXXXXXXXXXXXXXXXXXXXXXXXXXXXXXXXXXXXXXXXXXXXXXXXXXXXXXXXXXXXXXX
P       X     X                 X             X                 X         X       X X     X         X
X XXXXX X XXX X XXXXXXX X XXXXX XXXXXXXXXXX X X XXXXXXXXX XXXXX X X XXX X XXXXX X X X XXX XXX XXXXX X
X X     X   X   X     X X X   X     X       X X X   X     X   X X X   X X       X X X X       X   X X
X XXXXXXXXX XXXXX XXX X X X X XXXXX X XXXXXXX X X XXX XXX X X X X XXX X XXXXXXXXX X X XXXXXXXXX XXX X
X X   X       X   X X X X X X     X X X     X X   X   X     X X X     X     X   X   X   X   X       X
X X X X XXXXXXX XXX X X X X X XXXXX X X XXXXX XXX X XXX XXX XXX XXX XXXXXXX X XXXXX XXX X XXXXX XXXXX
X X X X     X   X   X X X X X     X X X X     X   X X   X X     X   X       X       X   X     X     X
X X X XXXXX X XXX X X X X XXXXXXX X X X X XXXXXXXXX XXX X X XXXXXXX X X XXXXXXX XXXXX XXXXXXX XXXXX X
X   X   X   X   X X   X X       X X   X X     X   X   X           X X X X     X     X     X   X X   X
X XXXXX X XXXXX XXX XXXXXXXXXXX X XXXXX XXXXX X X X X X XXXXXXXXX XXX XXX XXX XXXXX XXXXX X XXX X XXX
X     X X   X X   X   X         X         X X   X X X X       X     X X   X   X   X X   X   X   X X X
X XXXXX XXX X XXX XXX X XXXXXXX XXXXX XXX X XXXXX X X X X XXX XXXXX X X XXX XXX XXX X X XXXXXXX X X X
X X     X X   X X   X   X           X X   X   X   X X X X X   X   X   X   X X         X         X X X
X X XXX X XXX X XXX XXX XXXXXXX XXX X X XXXXX X XXX X X X X XXX X XXXXX XXX XXXXXXXXXXX XXXXX XXX X X
X X X   X   X X X   X           X   X X X     X   X X X X X     X   X   X   X     X     X   X X   X X
X X X XXXXX X X X XXXXXXX XXXXXXX XXX X X XXXXXXX X X XXX XXXXXXXXX X XXX X X XXX XXXXXXX X XXX XXX X
X X X       X   X X   X   X   X       X   X     X X X   X   X   X X     X X X   X X     X X     X   X
XXX X XXXXXXXXX X X X X X X X XXXXXXXXXXX X XXX X X XXX XXX X X X XXXXXXX XXXXX X X XXX X XXXXXXX X X
X   X X         X   X X X X X X   X       X X X   X   X   X   X X X       X     X   X X X   X     X X
X XXX X XXXXXXXXXXXXX X X X X X X XXXXX XXX X XXXXXXX XXX X XXX X X XXX XXX XXXXXXXXX X XXX XXXXXXX X
X   X X X     X   X X X X X X   X     X   X X       X   X       X X   X X   X         X   X         X
XXX X X X XXX X X X X X XXX XXXXXXXXX XXX X X XXXXX XXXXX XXXXXXX XXX X X XXXXXXX XXX XXX XXXXXXX X X
X   X X X   X X X   X X   X X   X   X X   X X X   X     X X       X   X X         X   X X         X X
X XXXXX X X X X XXX X X X X X X X XXX XXXXX X X XXXXXXX X X XXXXX X XXX XXXXXXXXXXX XXX X XXXXXXXXX X
X X     X X X   X X X X X     X X   X X     X X       X X X X     X X   X       X   X   X X   X     X
X X XXXXX X XXXXX X X XXXXXXXXX XXX X X XXXXX XXXXX X X X X X XXXXX XXXXX X XXXXX XXX X X X X X XXXXX
X X   X   X   X     X     X   X   X X   X     X   X X   X   X     X   X   X X         X X X X X   X X
X XXX XXXXXXX X XXXXXXXXX X X XXX X X XXX X XXX X X XXXXXXXXXXXXXXX X X XXX X XXXXXXXXXXX X X XXX X X
X     X       X   X     X X X   X   X     X X   X X               X X   X   X X   X       X X   X X X
X XXXXX XXXXXXXXX X XXXXX XXX X XXX XXXXX XXX XXX XXXXXXX XXXXXXX XXXXX X XXX X X X XXXXXXX X X X X X
X X     X   X   X X     X   X X   X     X X   X X   X   X X   X X     X X   X X X X     X   X X X   X
X X XXXXX X XXX X X XXX XXX XXXXX XXXXX X X XXX XXX X X X X X X XXXXX XXXXX X X X XXXXX X XXX XXXXX X
X   X     X     X X   X   X     X   X   X X   X   X X X X X X X     X       X   X X   X     X   X   X
XXXXXXX XXXXXXXXX XXXXX X XXXXX XXX X XXX XXX XXX X X X XXX X XXXXX XXXXXXX XXXXX XXX XXXXXXXXX X XXX
X       X       X     X X     X   X X   X   X     X   X   X X     X         X     X   X   X     X X X
X X XXX X XXXXX XXXXX X XXXXX XXX X XXX XXX XXXXX XXXXXXX X XXXXX X XXXXXXXXX XXXXX X X XXX X XXX X X
X X X   X X   X     X X     X X   X             X   X   X   X   X X       X   X     X   X   X X   X X
X X X XXX XXX XXX XXX XXXXXXX X XXXXXXXXXXXXXXXXXXX XXX XXXXX X X XXXXXXXXX XXX X XXXXX X XXXXX XXX X
X X X X         X X   X     X X                   X X   X   X X X X       X   X X     X X X   X X   X
XXX X X XXXXXXXXX X XXX XXX X X XXXXX XXXXX XXXXX X X X XXX X X X X XXXXX XXX XXX X X XXX X X X X X X
X   X           X X X   X X   X         X       X X   X     X X   X   X     X   X X X   X   X X X X X
X XXXXXXX X XXX X X X XXX XXX X XXX XXX XXXXXXX X XXXXXXXXX X X XXXXX X XXX XXX X X XXX XXX X X XXX X
X X       X X X   X     X   X X X   X   X     X X     X     X X X     X X       X   X   X     X   X X
X X XXXXXXX X XXX X XXX XXX X XXX XXX XXX XXX X X XXXXX XXXXX X X XXXXX X XXX XXXXXXX X X X X XXX X X
X   X   X   X     X     X   X   X X X     X   X X     X X X   X X   X   X   X       X X X X X     X X
X XXX X X XXXXXXXXXXXXXXX XXXXX X X XXXXXXX XXX XXXXX X X X XXXXXXX X XXXXX X XXXXX X X XXX XXXXXXX X
X     X X                         X                 X     X         X         X       X             K
XXXXXXXXXXXXXXXXXXXXXXXXXXXXXXXXXXXXXXXXXXXXXXXXXXXXXXXXXXXXXXXXXXXXXXXXXXXXXXXXXXXXXXXXXXXXXXXXXXXXX